000000000000000000000000
000000000000000000000000
000000000000000000000000
000000000000000000000000
000000001111111000000000
00000000100230100000t000
000000001000001000000000
000000001111111000000000
000000000000000000000000
000t00000000000000000000
000000000000000000000000
000000000000000000000000
